58 111 916 1 4 2 189
n                 r                    r                 p
n                 r                    r                 p
n                 r                    r                 p
n  s           s  r                    r                 p
n                 r                    r                 p
n                 r                    r  r              p
n                 r                    r  r    u    r    p
n                 r                    r  r    u    r    p
n                 r                    r  r    u    r    p
n                 r                    r  r    u    r    p
n                 r    ddddddddd       r  r    u    r    p
n                 r  dd                r  r    u    r    p
n  d d d          r  d                 r       u         p
n    d            r  d                 r                 p
n  ddddd          r  d                 r                 p
n    d            r  d                 r                 p
n  d d d          r  d                 r  u  r           p
n                 r  d        dddddd   r  u  r           p
n                 r  d                 r  u  r           p
n                 r  d                 r  u  r        r  p
n      uuuuuuu    r  d                 r  u  r        rz p
n      u u u u    r  d                 r  u  r        rz p
n      u u u u    r  d                 r  u  r        r  p
n      uuuuuuu    r  d                 r  u  r    r      p
n                 r  d     d           r     r    r      p
n                 r  d     d           r     r    r      p
n                 r  d     d           r     r    r      p
n                 r  d     d   dddd    r     r    r      p
n          d d    r  d     d      d    r     r    r      p
n  ddd u    d     r  d     d      d    r          r      p
n  d d u   d d    r  d     d      d    r          r      p
n  ddd u          r  d     d      d    r          r      p
n      u          r  d     d      d    r          r      p
n      u          r  d            d    r   r      r  r   p
n uuuuuu          r  d            d    r   r      r  r   p
n u               r  d            d    r   r      r  r   p
n u   ddddd    dd r  ddddd        d    r   r         r   p
n u   d b d    dd r               dd   r   r         r   p
n u   d z d       r                    r   r         r   p
n                 r                    r   r         r   p
n                 r ddddddddd     dd u r   r         r   p
n                 r d       ddd u d    r   r  r      r   p
n                 r d   u         d    r   r  r      r   p
n                 r d u    u      d  u r             r   p
n                 r d    d   u u  d    r             r   p
n                 r d    d        d    r             r   p
n      d          r   u  d  u   ddd  u r             r   p
n     ddd         r      d             r r           r   p
n      d  u       r      d             r r         r r u p
n         u       r   u  d  u  u u u u r r         r   u p
n         u       r      d             r r u       r   u p
n         u  d    r      d  u  ddddd   r r u       r   u p
n         u ddd   rd  u  d         d   r r u  r    r   u p
n            d    rd     d         d u r r u  r    r   u p
n                 rd     d  u u    d   r r u  r    r   u p
n   d             r   u  d      u  d   r r u  r    r   u p
n  ddd            r      dd        d   r r u  r    r     p
n   d             r       ddddd u  d   r r         r     p
n                 r   u            d u r r         r     p
n      u          r             u  d   r        u  r     p
n   c  u   d      r                d   r        u     r  p
n   d  u  ddd     r   u  u u u  u  d   r        u     r  p
n  ddd u   d      r                d   r     r  u     r  p
n   d  u          rdddd            d u r     r  u     rx p
n      u          r   d            d   r        u     r  p
n                 r   d     ddd    d   r              r  p
n                 r   d            d   r          r   r  p
n                 r   d                r          r   r xp
n          c      r              d   u r u r      r   r  p
n          d      r             dd     r u r          r  p
n         ddd     r                    r u r          r  p
n          d      r                    r u r          rx p
n                 gqqqqqqqe u  hqqqqqqqf u r          r  p
n                         r  u r         u r          r  p
n                         r u  r                         p
n   c                     r  u r                         p
n   d                     r u  r    r                    p
n  ddd                    r  u r    r                    p
n   d                     r u  r    r           r        p
n             c           r  u r    r           r        p
n             d           r u  r    r           r        p
n            ddd          r  u r    r           r        p
n             d           r u  r    r           r  u     p
n                         r  u r    r           r  u     p
n                         r u  r    r u  r      r  u  r  p
n                         r  u r      u  r      r  u  r  p
n                   ddddd r u  r      u  r      r  u  r  p
n   dddd   uuuuuuu      d r  u r      u  r         u  r  p
n   d      uuuuuuu   zz d r u  r  r   u  r         u  r  p
n   d z    uuuuuuu      d r  u r  r   u  r            r  p
n   d               ddddd r u  r  r   u  r            r  p
n   dddd                  r  u r  r      r            r  p
n                         r    r                      r  p
n                         r    r              r       r  p
n                         r    r              r          p
n                         r    r              r          p
n                         r    r                         p
n                         r    r                         p
 mmmmmmmmmmmmmmmmmmmme    r    r    hmmmmmmmmmmmmmmmmmmmm 
                     n    r    r    p                     
                     n    j    j    p                     
                     n              p                     
                     n              p                     
                     n              p                     
                     n              p                     
                     n              p                     
                     n              p                     
                     n       t      p                     
                     n              p                     
                     n              p                     
                      mmmmmmmmmmmmmm                      
8 37 270 
4 60 0 
11 68 180 
4 75 0 
14 79 180