19 150 466 12 5 13 71
e                 h
r        y        r
r    s  wxw  b    r
r    s   y        r
r                 r
r                 r
r                 r
r                 r
r     c           r
r                 r
r                 r
r              s  r
r          ww  s  r
r    b    ww      r
r                 r
r           b     r
r                 r
r                 r
r                 r
r         s       r
r    x            r
r   xyx           r
r    x            r
r                 r
r                 r
r            xx   r
r            xx   r
r                 r
r                 r
r                 r
r                 r
r                 r
r    c            r
r            b    r
r            b    r
r            b    r
r                 r
r                 r
r  w              r
r wxw             r
r  w    s         r
r                 r
r                 r
r                 r
r                 r
r                 r
r                 r
r                 r
r                 r
pmmmmmme u hmmmmmmn
p      n v p      n
p      n b p      n
p      f u g      n
p     f     g     n
p    n       p    n
p    n       p    n
p    f s     g    n
p   f         g   n
p  n           p  n
p  n           p  n
p  n       w  bp  n
p  n  c    w  bp  n
p  n        v  p  n
p  n        v  p  n
p  n           p  n
p  n           p  n
p  n           p  n
p  n           p  n
p  n           p  n
p  n           p  n
p  n           p  n
p  n           p  n
p  n   v       p  n
p  n  wxw      p  n
p  n   v       p  n
p  n           p  n
p  n        s  p  n
p  n           p  n
p  n           p  n
p  n   b       p  n
p  n     x     p  n
p  n           p  n
p  n           p  n
p  n           p  n
p  n           p  n
p  n           p  n
p  n  v        p  n
p  n  ww       p  n
p  n   v       p  n
p  n           p  n
p  n           p  n
p  n           p  n
p   e    s    h   n
p   n b       p   n
p    e       h    n
p    n       p    n
p     e     h     n
p      e u h      n
p      n u p      n
poooooof u goooooon
r                 r
r                 r
r                 r
r                 r
r                 r
r   wv            r
r   vw          c r
r                 r
r                 r
r       v         r
r       w         r
r       v         r
r       w         r
r  s        s     r
r                 r
r                 r
r                 r
r                 r
r                 r
r    u            r
r   vwv     s     r
r    u            r
r                 r
r                 r
r                 r
r        u        r
r        v      c r
r        u        r
r                 r
r                 r
r                 r
r   uu  b         r
r   uu            r
r                 r
r                 r
r                 r
r           uu    r
r           uu    r
r       s         r
r                 r
r                 r
r   uu            r
r   uu            r
r                 r
r                 r
pmme     t     hmme
p  n           p  n
p  {mmmme hmmmm{  n
p       d{d       n
gooooooooooooooooof
13 2 180 
6 8 315 
5 13 45 
12 15 90 
5 32 45 
13 33 180 
14 34 180 
14 35 180 
9 51 90 
14 60 180 
6 61 0 
14 61 180 
7 79 315 
6 93 0 
16 106 180 
16 126 180 
8 131 270 
